fipe_code;model_year;localiza_count;movida_count;total_count;localiza_present;movida_present
005540-9;2025;990;284;1274;True;True
005540-9;2024;188;835;1023;True;True
015245-5;2025;890;61;951;True;True
004517-9;2025;764;2;766;True;True
004517-9;2024;672;0;672;True;False
001494-0;2025;592;78;670;True;True
001461-3;2025;396;181;577;True;True
001461-3;2024;400;92;492;True;True
015234-0;2025;211;263;474;True;True
025266-2;2025;67;368;435;True;True
017088-7;2024;430;3;433;True;True
015245-5;2024;415;1;416;True;True
025266-2;2024;104;302;406;True;True
005510-7;2024;132;248;380;True;True
004519-5;2024;0;357;357;False;True
001536-9;2024;302;2;304;True;True
005526-3;2024;263;11;274;True;True
005535-2;2024;40;226;266;True;True
015239-0;2025;213;52;265;True;True
005509-3;2024;239;14;253;True;True
004502-0;2024;246;3;249;True;True
001494-0;2024;218;13;231;True;True
002207-1;2025;0;231;231;False;True
004525-0;2024;231;0;231;True;False
015240-4;2025;225;1;226;True;True
004518-7;2025;223;2;225;True;True
001505-9;2024;222;0;222;True;False
017071-2;2024;200;4;204;True;True
004518-7;2024;196;0;196;True;False
005525-5;2024;76;117;193;True;True
015234-0;2024;127;63;190;True;True
001553-9;2024;169;16;185;True;True
001461-3;2023;154;29;183;True;True
015190-4;2025;7;164;171;True;True
004522-5;2025;161;5;166;True;True
005533-6;2024;116;49;165;True;True
011223-2;2024;150;4;154;True;True
001544-0;2024;105;44;149;True;True
001531-8;2024;142;4;146;True;True
004522-5;2024;139;2;141;True;True
005528-0;2023;140;1;141;True;True
015240-4;2024;140;0;140;True;False
017071-2;2023;136;3;139;True;True
024264-0;2024;118;20;138;True;True
001526-1;2023;120;6;126;True;True
004502-0;2023;121;3;124;True;True
004504-7;2025;123;0;123;True;False
002168-7;2025;0;122;122;False;True
001553-9;2025;112;8;120;True;True
005538-7;2024;59;61;120;True;True
023178-9;2024;106;5;111;True;True
017071-2;2025;110;0;110;True;False
001509-1;2025;89;18;107;True;True
005508-5;2024;107;0;107;True;False
015244-7;2025;99;4;103;True;True
004532-2;2024;98;0;98;True;False
001569-5;2024;91;6;97;True;True
004494-6;2024;95;1;96;True;True
004504-7;2024;92;0;92;True;False
004494-6;2025;88;0;88;True;False
025301-4;2024;80;6;86;True;True
015215-3;2024;84;1;85;True;True
015239-0;2024;80;1;81;True;True
004502-0;2025;76;1;77;True;True
005534-4;2024;77;0;77;True;False
001542-3;2024;59;16;75;True;True
005510-7;2025;17;58;75;True;True
005535-2;2025;72;3;75;True;True
015244-7;2024;74;0;74;True;False
015236-6;2024;69;1;70;True;True
001494-0;2023;66;3;69;True;True
017088-7;2023;68;1;69;True;True
005509-3;2025;26;40;66;True;True
025300-6;2024;66;0;66;True;False
004503-9;2023;64;0;64;True;False
004525-0;2023;63;0;63;True;False
017071-2;2022;63;0;63;True;False
023186-0;2024;60;3;63;True;True
004541-1;2025;62;0;62;True;False
005543-3;2024;34;28;62;True;True
001569-5;2025;58;1;59;True;True
005484-4;2024;59;0;59;True;False
017035-6;2021;59;0;59;True;False
025290-5;2025;0;59;59;False;True
001509-1;2024;46;9;55;True;True
001558-0;2024;54;0;54;True;False
005508-5;2022;53;1;54;True;True
001509-1;2023;43;9;52;True;True
004517-9;2023;47;5;52;True;True
015165-3;2024;52;0;52;True;False
004494-6;2023;50;0;50;True;False
004516-0;2025;50;0;50;True;False
005527-1;2023;49;1;50;True;True
024263-2;2024;50;0;50;True;False
004525-0;2025;46;2;48;True;True
001538-5;2024;45;1;46;True;True
001554-7;2024;41;5;46;True;True
004516-0;2024;45;0;45;True;False
005508-5;2025;43;2;45;True;True
025322-7;2024;45;0;45;True;False
025328-6;2025;0;45;45;False;True
004515-2;2024;40;3;43;True;True
011232-1;2025;43;0;43;True;False
001531-8;2025;41;1;42;True;True
005485-2;2024;41;1;42;True;True
001505-9;2025;41;0;41;True;False
004501-2;2024;40;1;41;True;True
017081-0;2024;41;0;41;True;False
005492-5;2023;40;0;40;True;False
002203-9;2025;0;39;39;False;True
005508-5;2023;38;1;39;True;True
005538-7;2025;30;9;39;True;True
001453-2;2024;37;0;37;True;False
017088-7;2025;37;0;37;True;False
001505-9;2023;36;0;36;True;False
005527-1;2024;24;12;36;True;True
005528-0;2024;35;1;36;True;True
004538-1;2023;35;0;35;True;False
004541-1;2024;34;0;34;True;False
017081-0;2025;34;0;34;True;False
001531-8;2023;32;1;33;True;True
011223-2;2025;33;0;33;True;False
015235-8;2024;33;0;33;True;False
017081-0;2023;32;1;33;True;True
004540-3;2024;32;0;32;True;False
025266-2;2023;26;6;32;True;True
001554-7;2025;31;0;31;True;False
004518-7;2023;30;1;31;True;True
005536-0;2024;31;0;31;True;False
001542-3;2025;28;1;29;True;True
001544-0;2025;7;22;29;True;True
005459-3;2023;29;0;29;True;False
015217-0;2024;29;0;29;True;False
005542-5;2025;28;0;28;True;False
017085-2;2024;6;22;28;True;True
017088-7;2022;28;0;28;True;False
096002-0;2025;28;0;28;True;False
001538-5;2023;25;0;25;True;False
001558-0;2023;25;0;25;True;False
025267-0;2025;2;23;25;True;True
001555-5;2024;24;0;24;True;False
001530-0;2024;23;0;23;True;False
015200-5;2024;23;0;23;True;False
025290-5;2024;0;23;23;False;True
001538-5;2025;22;0;22;True;False
005526-3;2023;22;0;22;True;False
015236-6;2025;20;2;22;True;True
001530-0;2025;21;0;21;True;False
001558-0;2025;19;2;21;True;True
004532-2;2025;21;0;21;True;False
005543-3;2025;14;7;21;True;True
004395-8;2024;20;0;20;True;False
015235-8;2025;20;0;20;True;False
023187-8;2024;20;0;20;True;False
001526-1;2022;18;1;19;True;True
004515-2;2025;15;4;19;True;True
005542-5;2024;16;3;19;True;True
011223-2;2023;19;0;19;True;False
002111-3;2023;18;0;18;True;False
008279-1;2024;18;0;18;True;False
001536-9;2025;2;15;17;True;True
004413-0;2024;17;0;17;True;False
005490-9;2023;17;0;17;True;False
005538-7;2023;0;17;17;False;True
017080-1;2023;17;0;17;True;False
017082-8;2023;17;0;17;True;False
023187-8;2023;17;0;17;True;False
001453-2;2023;16;0;16;True;False
005509-3;2023;16;0;16;True;False
001542-3;2023;13;2;15;True;True
004501-2;2025;13;2;15;True;True
004515-2;2023;15;0;15;True;False
015190-4;2024;15;0;15;True;False
001509-1;2022;12;2;14;True;True
015214-5;2024;14;0;14;True;False
025327-8;2025;0;14;14;False;True
001544-0;2023;11;2;13;True;True
004513-6;2023;13;0;13;True;False
004522-5;2023;13;0;13;True;False
005525-5;2023;13;0;13;True;False
015202-1;2024;13;0;13;True;False
017070-4;2023;12;1;13;True;True
023180-0;2024;13;0;13;True;False
024249-7;2023;13;0;13;True;False
001461-3;2022;8;4;12;True;True
004413-0;2023;12;0;12;True;False
005509-3;2022;12;0;12;True;False
015215-3;2023;12;0;12;True;False
004540-3;2023;11;0;11;True;False
015237-4;2025;10;1;11;True;True
017070-4;2022;11;0;11;True;False
004470-9;2023;10;0;10;True;False
004502-0;2022;10;0;10;True;False
009172-3;2022;10;0;10;True;False
024249-7;2024;8;2;10;True;True
025266-2;2022;10;0;10;True;False
002168-7;2024;0;9;9;False;True
004519-5;2025;5;4;9;True;True
004529-2;2023;9;0;9;True;False
005485-2;2022;9;0;9;True;False
005526-3;2021;9;0;9;True;False
005526-3;2022;9;0;9;True;False
005536-0;2025;8;1;9;True;True
015213-7;2024;9;0;9;True;False
015218-8;2024;7;2;9;True;True
017085-2;2023;9;0;9;True;False
024176-8;2023;9;0;9;True;False
025322-7;2025;8;1;9;True;True
001557-1;2024;8;0;8;True;False
004504-7;2023;8;0;8;True;False
005510-7;2023;8;0;8;True;False
005528-0;2022;8;0;8;True;False
005540-9;2023;1;7;8;True;True
015233-1;2024;8;0;8;True;False
015237-4;2024;8;0;8;True;False
001530-0;2023;7;0;7;True;False
001554-7;2023;7;0;7;True;False
002207-1;2024;0;7;7;False;True
004395-8;2023;7;0;7;True;False
004498-9;2023;7;0;7;True;False
004500-4;2024;7;0;7;True;False
005493-3;2022;7;0;7;True;False
015206-4;2024;7;0;7;True;False
017075-5;2023;7;0;7;True;False
017081-0;2022;7;0;7;True;False
001494-0;2022;6;0;6;True;False
001542-3;2022;6;0;6;True;False
004501-2;2023;6;0;6;True;False
004539-0;2024;6;0;6;True;False
005485-2;2025;5;1;6;True;True
005491-7;2022;6;0;6;True;False
015165-3;2023;6;0;6;True;False
015238-2;2024;6;0;6;True;False
017080-1;2022;6;0;6;True;False
024264-0;2023;6;0;6;True;False
001553-9;2023;5;0;5;True;False
004512-8;2024;5;0;5;True;False
004542-0;2024;5;0;5;True;False
005484-4;2022;5;0;5;True;False
005509-3;2021;5;0;5;True;False
005532-8;2023;5;0;5;True;False
005533-6;2023;5;0;5;True;False
005542-5;2023;5;0;5;True;False
011224-0;2024;5;0;5;True;False
015201-3;2024;5;0;5;True;False
015209-9;2024;5;0;5;True;False
017082-8;2025;5;0;5;True;False
022164-3;2023;4;1;5;True;True
023161-4;2024;0;5;5;False;True
025313-8;2023;5;0;5;True;False
095005-0;2024;5;0;5;True;False
001453-2;2022;4;0;4;True;False
001538-5;2022;4;0;4;True;False
002142-3;2024;4;0;4;True;False
004470-9;2022;4;0;4;True;False
004511-0;2025;0;4;4;False;True
004512-8;2023;4;0;4;True;False
004512-8;2025;4;0;4;True;False
004525-0;2021;4;0;4;True;False
004525-0;2022;4;0;4;True;False
004541-1;2023;4;0;4;True;False
005534-4;2025;4;0;4;True;False
008279-1;2023;4;0;4;True;False
009164-2;2024;4;0;4;True;False
015164-5;2022;4;0;4;True;False
015190-4;2023;4;0;4;True;False
015214-5;2023;3;1;4;True;True
015217-0;2023;4;0;4;True;False
015218-8;2023;4;0;4;True;False
015242-0;2024;4;0;4;True;False
015242-0;2025;4;0;4;True;False
015243-9;2025;4;0;4;True;False
017070-4;2025;4;0;4;True;False
017075-5;2022;3;1;4;True;True
023178-9;2022;3;1;4;True;True
025267-0;2023;4;0;4;True;False
025301-4;2023;4;0;4;True;False
025313-8;2025;4;0;4;True;False
025319-7;2024;4;0;4;True;False
025325-1;2025;2;2;4;True;True
025331-6;2025;0;4;4;False;True
029159-5;2024;3;1;4;True;True
001487-7;2022;3;0;3;True;False
001494-0;2021;3;0;3;True;False
001519-9;2024;3;0;3;True;False
001556-3;2024;3;0;3;True;False
002111-3;2022;3;0;3;True;False
004517-9;2022;3;0;3;True;False
004519-5;2023;3;0;3;True;False
005483-6;2023;3;0;3;True;False
005484-4;2023;3;0;3;True;False
005484-4;2025;3;0;3;True;False
005489-5;2021;3;0;3;True;False
005506-9;2023;3;0;3;True;False
005531-0;2023;3;0;3;True;False
005543-3;2023;3;0;3;True;False
005547-6;2024;3;0;3;True;False
008250-3;2020;3;0;3;True;False
008256-2;2023;3;0;3;True;False
008256-2;2024;3;0;3;True;False
008280-5;2023;3;0;3;True;False
009213-4;2024;3;0;3;True;False
011224-0;2023;3;0;3;True;False
015168-8;2022;3;0;3;True;False
015174-2;2022;3;0;3;True;False
015200-5;2023;3;0;3;True;False
017046-1;2021;3;0;3;True;False
017070-4;2024;1;2;3;True;True
017077-1;2022;3;0;3;True;False
017080-1;2024;3;0;3;True;False
017083-6;2023;3;0;3;True;False
023175-4;2024;3;0;3;True;False
023181-9;2024;3;0;3;True;False
025196-8;2021;3;0;3;True;False
025205-0;2023;3;0;3;True;False
025267-0;2024;2;1;3;True;True
025300-6;2023;3;0;3;True;False
001453-2;2025;2;0;2;True;False
001505-9;2022;2;0;2;True;False
001506-7;2022;2;0;2;True;False
001519-9;2025;2;0;2;True;False
001531-8;2021;2;0;2;True;False
001556-3;2023;2;0;2;True;False
001557-1;2023;2;0;2;True;False
002111-3;2024;2;0;2;True;False
002168-7;2023;2;0;2;True;False
002182-2;2024;2;0;2;True;False
002200-4;2023;2;0;2;True;False
002201-2;2024;1;1;2;True;True
002203-9;2024;0;2;2;False;True
003433-9;2023;2;0;2;True;False
004514-4;2024;1;1;2;True;True
004518-7;2022;2;0;2;True;False
004532-2;2023;2;0;2;True;False
004540-3;2025;2;0;2;True;False
005508-5;2021;2;0;2;True;False
005527-1;2022;2;0;2;True;False
005531-0;2025;2;0;2;True;False
005533-6;2025;2;0;2;True;False
005546-8;2025;2;0;2;True;False
008249-0;2023;2;0;2;True;False
008259-7;2020;2;0;2;True;False
008287-2;2023;2;0;2;True;False
009254-1;2022;2;0;2;True;False
011198-8;2022;2;0;2;True;False
011226-7;2024;2;0;2;True;False
015206-4;2022;2;0;2;True;False
015206-4;2023;2;0;2;True;False
015213-7;2023;2;0;2;True;False
015243-9;2024;2;0;2;True;False
017082-8;2024;2;0;2;True;False
017083-6;2025;2;0;2;True;False
022189-9;2023;2;0;2;True;False
024215-2;2023;2;0;2;True;False
025196-8;2023;2;0;2;True;False
025197-6;2023;1;1;2;True;True
025319-7;2023;2;0;2;True;False
093004-0;2023;2;0;2;True;False
093013-0;2024;2;0;2;True;False
001352-8;2021;1;0;1;True;False
001461-3;2021;1;0;1;True;False
001487-7;2023;1;0;1;True;False
001520-2;2021;1;0;1;True;False
001527-0;2024;1;0;1;True;False
001527-0;2025;1;0;1;True;False
001531-8;2022;1;0;1;True;False
001539-3;2024;1;0;1;True;False
001539-3;2025;1;0;1;True;False
001546-6;2024;1;0;1;True;False
001549-0;2022;1;0;1;True;False
002015-0;2024;1;0;1;True;False
002112-1;2021;1;0;1;True;False
002112-1;2024;1;0;1;True;False
002145-8;2024;1;0;1;True;False
002181-4;2023;1;0;1;True;False
002203-9;2023;1;0;1;True;False
002204-7;2025;1;0;1;True;False
003363-4;2023;1;0;1;True;False
003421-5;2023;1;0;1;True;False
003426-6;2023;1;0;1;True;False
003465-7;2021;1;0;1;True;False
003478-9;2025;1;0;1;True;False
003481-9;2022;1;0;1;True;False
003481-9;2023;1;0;1;True;False
004397-4;2024;1;0;1;True;False
004397-4;2025;1;0;1;True;False
004413-0;2022;1;0;1;True;False
004435-0;2024;1;0;1;True;False
004474-1;2022;0;1;1;False;True
004494-6;2022;1;0;1;True;False
004500-4;2025;1;0;1;True;False
004501-2;2020;1;0;1;True;False
004503-9;2021;1;0;1;True;False
004509-8;2020;1;0;1;True;False
004509-8;2023;1;0;1;True;False
004514-4;2025;0;1;1;False;True
004516-0;2023;1;0;1;True;False
004519-5;2021;1;0;1;True;False
004520-9;2020;1;0;1;True;False
004529-2;2022;1;0;1;True;False
004542-0;2025;1;0;1;True;False
005459-3;2022;1;0;1;True;False
005479-8;2022;1;0;1;True;False
005489-5;2019;1;0;1;True;False
005490-9;2022;1;0;1;True;False
005491-7;2021;1;0;1;True;False
005492-5;2022;1;0;1;True;False
005501-8;2022;1;0;1;True;False
005510-7;2022;1;0;1;True;False
005517-4;2021;1;0;1;True;False
005534-4;2023;1;0;1;True;False
005537-9;2025;0;1;1;False;True
008238-4;2023;1;0;1;True;False
008245-7;2022;1;0;1;True;False
008247-3;2021;1;0;1;True;False
008250-3;2023;1;0;1;True;False
008256-2;2020;1;0;1;True;False
008259-7;2022;1;0;1;True;False
008275-9;2024;1;0;1;True;False
008278-3;2024;1;0;1;True;False
008279-1;2022;1;0;1;True;False
008284-8;2023;1;0;1;True;False
008284-8;2024;1;0;1;True;False
008285-6;2023;1;0;1;True;False
008288-0;2023;1;0;1;True;False
008289-9;2024;1;0;1;True;False
008302-0;2024;1;0;1;True;False
009164-2;2022;1;0;1;True;False
009164-2;2023;1;0;1;True;False
009165-0;2024;1;0;1;True;False
009213-4;2023;1;0;1;True;False
009236-3;2023;1;0;1;True;False
009239-8;2022;1;0;1;True;False
009271-1;2021;1;0;1;True;False
011197-0;2024;1;0;1;True;False
011198-8;2023;1;0;1;True;False
011216-0;2024;1;0;1;True;False
015203-0;2024;1;0;1;True;False
015204-8;2022;1;0;1;True;False
015205-6;2024;1;0;1;True;False
015212-9;2024;1;0;1;True;False
015233-1;2025;1;0;1;True;False
015238-2;2025;1;0;1;True;False
017034-8;2021;1;0;1;True;False
017045-3;2021;1;0;1;True;False
017047-0;2021;1;0;1;True;False
017072-0;2022;1;0;1;True;False
017074-7;2023;1;0;1;True;False
017074-7;2024;1;0;1;True;False
017087-9;2023;1;0;1;True;False
021437-0;2022;1;0;1;True;False
021462-0;2022;1;0;1;True;False
022158-9;2023;1;0;1;True;False
022164-3;2022;1;0;1;True;False
022167-8;2023;1;0;1;True;False
022170-8;2022;1;0;1;True;False
022170-8;2023;1;0;1;True;False
022171-6;2022;1;0;1;True;False
022181-3;2023;1;0;1;True;False
023160-6;2022;0;1;1;False;True
023161-4;2023;0;1;1;False;True
023163-0;2022;0;1;1;False;True
023174-6;2025;1;0;1;True;False
023178-9;2023;0;1;1;False;True
023181-9;2022;1;0;1;True;False
023187-8;2025;1;0;1;True;False
023189-4;2023;1;0;1;True;False
023189-4;2025;1;0;1;True;False
024176-8;2022;1;0;1;True;False
024215-2;2022;1;0;1;True;False
024245-4;2022;0;1;1;False;True
024249-7;2022;1;0;1;True;False
024260-8;2024;1;0;1;True;False
024263-2;2023;1;0;1;True;False
025196-8;2022;1;0;1;True;False
025198-4;2023;1;0;1;True;False
025205-0;2024;1;0;1;True;False
025267-0;2022;1;0;1;True;False
025285-9;2021;1;0;1;True;False
025309-0;2023;1;0;1;True;False
025310-3;2024;1;0;1;True;False
025312-0;2023;1;0;1;True;False
025312-0;2024;1;0;1;True;False
025312-0;2025;1;0;1;True;False
025313-8;2024;1;0;1;True;False
025317-0;2023;1;0;1;True;False
029154-4;2023;1;0;1;True;False
029157-9;2023;1;0;1;True;False
029157-9;2024;1;0;1;True;False
033186-4;2022;0;1;1;False;True
035120-2;2021;1;0;1;True;False
073029-7;2023;0;1;1;False;True
080035-0;2023;1;0;1;True;False
093010-5;2024;1;0;1;True;False
093012-1;2023;0;1;1;False;True
093013-0;2025;1;0;1;True;False
095006-8;2025;1;0;1;True;False
095007-6;2024;1;0;1;True;False
095008-4;2024;1;0;1;True;False
096001-2;2024;1;0;1;True;False
096001-2;2025;1;0;1;True;False
096002-0;2024;1;0;1;True;False
096003-9;2025;1;0;1;True;False
600005;2023;0;1;1;False;True
