fipe_code;model_year;localiza_count;movida_count;total_count;localiza_present;movida_present
005540-9;2025;861;351;1212;True;True
005540-9;2024;330;727;1057;True;True
004517-9;2025;717;3;720;True;True
004517-9;2024;710;1;711;True;True
015245-5;2025;633;53;686;True;True
001494-0;2025;573;67;640;True;True
001461-3;2024;498;94;592;True;True
001461-3;2025;304;212;516;True;True
015245-5;2024;476;0;476;True;False
025266-2;2025;64;396;460;True;True
025266-2;2024;128;312;440;True;True
001536-9;2024;434;1;435;True;True
017088-7;2024;429;3;432;True;True
004519-5;2024;0;392;392;False;True
005510-7;2024;156;215;371;True;True
005526-3;2024;321;6;327;True;True
015234-0;2025;158;169;327;True;True
015239-0;2025;187;117;304;True;True
015190-4;2025;6;254;260;True;True
025290-5;2025;1;259;260;True;True
002207-1;2025;0;259;259;False;True
004518-7;2025;257;1;258;True;True
001494-0;2024;232;15;247;True;True
004502-0;2024;241;5;246;True;True
004525-0;2024;228;0;228;True;False
005509-3;2024;211;15;226;True;True
005535-2;2024;27;194;221;True;True
005525-5;2024;90;130;220;True;True
017071-2;2024;213;4;217;True;True
001553-9;2024;183;31;214;True;True
004522-5;2024;207;2;209;True;True
001461-3;2023;164;34;198;True;True
004518-7;2024;198;0;198;True;False
001505-9;2024;196;1;197;True;True
002168-7;2025;0;183;183;False;True
015240-4;2025;182;1;183;True;True
005528-0;2023;174;0;174;True;False
015234-0;2024;128;45;173;True;True
001544-0;2024;118;50;168;True;True
015240-4;2024;162;0;162;True;False
004522-5;2025;147;9;156;True;True
024264-0;2024;133;23;156;True;True
001526-1;2023;147;6;153;True;True
004504-7;2025;138;0;138;True;False
023178-9;2024;127;10;137;True;True
005538-7;2024;60;74;134;True;True
001553-9;2025;117;15;132;True;True
005508-5;2024;131;1;132;True;True
005533-6;2024;81;48;129;True;True
001531-8;2024;120;7;127;True;True
005510-7;2025;36;87;123;True;True
004502-0;2023;117;3;120;True;True
011223-2;2024;115;1;116;True;True
017071-2;2023;106;5;111;True;True
001509-1;2025;98;12;110;True;True
015239-0;2024;105;2;107;True;True
017071-2;2025;99;1;100;True;True
015244-7;2025;95;3;98;True;True
025301-4;2024;93;4;97;True;True
015236-6;2024;94;0;94;True;False
004494-6;2024;90;1;91;True;True
001509-1;2024;65;23;88;True;True
001569-5;2024;72;13;85;True;True
004502-0;2025;83;2;85;True;True
004504-7;2024;85;0;85;True;False
004494-6;2025;82;0;82;True;False
015215-3;2024;80;1;81;True;True
005535-2;2025;65;13;78;True;True
001569-5;2025;71;6;77;True;True
005534-4;2024;77;0;77;True;False
001509-1;2023;55;20;75;True;True
005508-5;2025;72;3;75;True;True
005509-3;2025;30;45;75;True;True
001542-3;2024;60;14;74;True;True
015244-7;2024;72;0;72;True;False
001494-0;2023;56;7;63;True;True
004525-0;2023;63;0;63;True;False
017088-7;2023;60;3;63;True;True
017035-6;2021;60;2;62;True;True
025300-6;2024;61;0;61;True;False
005543-3;2024;25;35;60;True;True
004517-9;2023;55;4;59;True;True
004541-1;2025;59;0;59;True;False
017088-7;2025;55;3;58;True;True
004515-2;2024;55;1;56;True;True
023186-0;2024;53;3;56;True;True
004494-6;2023;55;0;55;True;False
004503-9;2023;54;1;55;True;True
004525-0;2025;54;1;55;True;True
025266-2;2023;49;6;55;True;True
001554-7;2024;50;4;54;True;True
004516-0;2025;52;0;52;True;False
005484-4;2024;52;0;52;True;False
005538-7;2025;35;17;52;True;True
005485-2;2024;49;2;51;True;True
005527-1;2023;50;1;51;True;True
001505-9;2025;50;0;50;True;False
024263-2;2024;50;0;50;True;False
015165-3;2024;49;0;49;True;False
017071-2;2022;48;0;48;True;False
017081-0;2023;47;0;47;True;False
001531-8;2025;43;2;45;True;True
005492-5;2023;40;4;44;True;True
001538-5;2024;43;0;43;True;False
005508-5;2023;43;0;43;True;False
017081-0;2024;43;0;43;True;False
004538-1;2023;42;0;42;True;False
001558-0;2024;41;0;41;True;False
005508-5;2022;40;0;40;True;False
001554-7;2025;38;1;39;True;True
005527-1;2024;27;11;38;True;True
005528-0;2024;36;2;38;True;True
017085-2;2024;7;31;38;True;True
002203-9;2025;0;37;37;False;True
004532-2;2024;37;0;37;True;False
011232-1;2025;37;0;37;True;False
001505-9;2023;36;0;36;True;False
004501-2;2024;33;3;36;True;True
004516-0;2024;36;0;36;True;False
017081-0;2025;36;0;36;True;False
025322-7;2024;36;0;36;True;False
015217-0;2024;34;1;35;True;True
025267-0;2025;1;34;35;True;True
001542-3;2025;33;1;34;True;True
005459-3;2023;33;0;33;True;False
005542-5;2025;33;0;33;True;False
005542-5;2024;28;4;32;True;True
025328-6;2025;0;32;32;False;True
004541-1;2024;31;0;31;True;False
004413-0;2024;28;2;30;True;True
011223-2;2025;28;2;30;True;True
001538-5;2025;28;0;28;True;False
005536-0;2024;28;0;28;True;False
001544-0;2025;4;23;27;True;True
015235-8;2024;26;0;26;True;False
005509-3;2023;24;1;25;True;True
025290-5;2024;1;24;25;True;True
001536-9;2025;2;22;24;True;True
001542-3;2023;19;5;24;True;True
004518-7;2023;23;1;24;True;True
001530-0;2024;23;0;23;True;False
001530-0;2025;23;0;23;True;False
001531-8;2023;23;0;23;True;False
001558-0;2025;22;1;23;True;True
004395-8;2024;23;0;23;True;False
001453-2;2024;22;0;22;True;False
005526-3;2023;22;0;22;True;False
017088-7;2022;20;2;22;True;True
096002-0;2025;22;0;22;True;False
004515-2;2023;21;0;21;True;False
005538-7;2023;0;21;21;False;True
015200-5;2024;21;0;21;True;False
023187-8;2024;21;0;21;True;False
001555-5;2024;20;0;20;True;False
008279-1;2024;20;0;20;True;False
004515-2;2025;15;4;19;True;True
004540-3;2024;19;0;19;True;False
001538-5;2023;17;1;18;True;True
001558-0;2023;18;0;18;True;False
004532-2;2025;18;0;18;True;False
017082-8;2023;18;0;18;True;False
001453-2;2023;16;1;17;True;True
001526-1;2022;17;0;17;True;False
004500-4;2024;17;0;17;True;False
005490-9;2023;14;3;17;True;True
005536-0;2025;15;2;17;True;True
004501-2;2025;13;3;16;True;True
004522-5;2023;16;0;16;True;False
002111-3;2023;15;0;15;True;False
005528-0;2022;15;0;15;True;False
015235-8;2025;15;0;15;True;False
011223-2;2023;14;0;14;True;False
005543-3;2025;9;4;13;True;True
009172-3;2022;13;0;13;True;False
004513-6;2023;12;0;12;True;False
005540-9;2023;1;11;12;True;True
015190-4;2024;12;0;12;True;False
015214-5;2024;12;0;12;True;False
015236-6;2025;11;1;12;True;True
017070-4;2022;12;0;12;True;False
023187-8;2023;12;0;12;True;False
025327-8;2025;0;12;12;False;True
001461-3;2022;8;3;11;True;True
001544-0;2023;10;1;11;True;True
004413-0;2023;8;3;11;True;True
004519-5;2025;6;5;11;True;True
004540-3;2023;11;0;11;True;False
005493-3;2022;11;0;11;True;False
005526-3;2021;11;0;11;True;False
005526-3;2022;11;0;11;True;False
015237-4;2025;10;1;11;True;True
023180-0;2024;11;0;11;True;False
024249-7;2024;5;6;11;True;True
025266-2;2022;11;0;11;True;False
004470-9;2023;10;0;10;True;False
015202-1;2024;10;0;10;True;False
015218-8;2024;9;1;10;True;True
017070-4;2023;9;1;10;True;True
017080-1;2023;10;0;10;True;False
002142-3;2024;9;0;9;True;False
002203-9;2024;2;7;9;True;True
004395-8;2023;9;0;9;True;False
005525-5;2023;9;0;9;True;False
015165-3;2023;9;0;9;True;False
015237-4;2024;8;1;9;True;True
015238-2;2024;9;0;9;True;False
015243-9;2025;8;1;9;True;True
024249-7;2023;8;1;9;True;True
024264-0;2023;8;1;9;True;True
002207-1;2024;0;8;8;False;True
004529-2;2023;8;0;8;True;False
005485-2;2022;8;0;8;True;False
005510-7;2023;8;0;8;True;False
015213-7;2024;8;0;8;True;False
017081-0;2022;8;0;8;True;False
017085-2;2023;8;0;8;True;False
025267-0;2023;8;0;8;True;False
025267-0;2024;3;5;8;True;True
025322-7;2025;7;1;8;True;True
001553-9;2023;7;0;7;True;False
001557-1;2024;6;1;7;True;True
002168-7;2024;0;7;7;False;True
004502-0;2022;7;0;7;True;False
004504-7;2023;7;0;7;True;False
004512-8;2023;7;0;7;True;False
005509-3;2022;7;0;7;True;False
005534-4;2025;7;0;7;True;False
015206-4;2024;7;0;7;True;False
017075-5;2022;7;0;7;True;False
017080-1;2022;7;0;7;True;False
017082-8;2025;7;0;7;True;False
004470-9;2022;6;0;6;True;False
004512-8;2024;6;0;6;True;False
004512-8;2025;6;0;6;True;False
005485-2;2025;6;0;6;True;False
005509-3;2021;6;0;6;True;False
015233-1;2024;6;0;6;True;False
017070-4;2025;6;0;6;True;False
017075-5;2023;5;1;6;True;True
025313-8;2025;5;1;6;True;True
001453-2;2025;5;0;5;True;False
001494-0;2022;5;0;5;True;False
001509-1;2022;3;2;5;True;True
001554-7;2023;5;0;5;True;False
004501-2;2023;5;0;5;True;False
004518-7;2022;5;0;5;True;False
004525-0;2022;5;0;5;True;False
005484-4;2022;5;0;5;True;False
005491-7;2022;4;1;5;True;True
005531-0;2025;5;0;5;True;False
011226-7;2024;3;2;5;True;True
011230-5;2025;5;0;5;True;False
015206-4;2022;5;0;5;True;False
015215-3;2023;5;0;5;True;False
015242-0;2024;5;0;5;True;False
017083-6;2023;5;0;5;True;False
022164-3;2023;3;2;5;True;True
023161-4;2024;0;5;5;False;True
025290-5;2023;4;1;5;True;True
025331-6;2025;0;5;5;False;True
095005-0;2024;5;0;5;True;False
001453-2;2022;4;0;4;True;False
001487-7;2022;4;0;4;True;False
004500-4;2025;4;0;4;True;False
004525-0;2021;4;0;4;True;False
004550-0;2025;4;0;4;True;False
005484-4;2023;4;0;4;True;False
005489-5;2021;4;0;4;True;False
005527-1;2022;4;0;4;True;False
005533-6;2023;4;0;4;True;False
005542-5;2023;4;0;4;True;False
008279-1;2023;4;0;4;True;False
009164-2;2024;4;0;4;True;False
011224-0;2023;2;2;4;True;True
015216-1;2024;3;1;4;True;True
017070-4;2024;2;2;4;True;True
024176-8;2023;4;0;4;True;False
025300-6;2023;4;0;4;True;False
025301-4;2023;4;0;4;True;False
001505-9;2022;3;0;3;True;False
001520-2;2021;3;0;3;True;False
001530-0;2023;3;0;3;True;False
001556-3;2023;3;0;3;True;False
001561-0;2025;3;0;3;True;False
002168-7;2023;3;0;3;True;False
002182-2;2024;3;0;3;True;False
003363-4;2023;3;0;3;True;False
004511-0;2025;0;3;3;False;True
004540-3;2025;3;0;3;True;False
004542-0;2025;3;0;3;True;False
005484-4;2025;3;0;3;True;False
005485-2;2023;3;0;3;True;False
005506-9;2023;3;0;3;True;False
005535-2;2023;1;2;3;True;True
008256-2;2023;3;0;3;True;False
008256-2;2024;3;0;3;True;False
008280-5;2023;3;0;3;True;False
008287-2;2023;3;0;3;True;False
009164-2;2022;3;0;3;True;False
011197-0;2024;3;0;3;True;False
011224-0;2024;2;1;3;True;True
015190-4;2023;3;0;3;True;False
015201-3;2024;3;0;3;True;False
015203-0;2024;3;0;3;True;False
015206-4;2023;3;0;3;True;False
015209-9;2024;3;0;3;True;False
015212-9;2024;3;0;3;True;False
015213-7;2023;3;0;3;True;False
015214-5;2023;3;0;3;True;False
017047-0;2021;3;0;3;True;False
017077-1;2022;3;0;3;True;False
017080-1;2024;3;0;3;True;False
017082-8;2024;3;0;3;True;False
024215-2;2023;3;0;3;True;False
025313-8;2023;3;0;3;True;False
025319-7;2024;2;1;3;True;True
025325-1;2025;0;3;3;False;True
029159-5;2024;3;0;3;True;False
001542-3;2022;1;1;2;True;True
001556-3;2024;2;0;2;True;False
002111-3;2022;2;0;2;True;False
002111-3;2024;2;0;2;True;False
002181-4;2024;0;2;2;False;True
002200-4;2023;2;0;2;True;False
002201-2;2023;2;0;2;True;False
002203-9;2023;2;0;2;True;False
003433-9;2023;2;0;2;True;False
003463-0;2020;2;0;2;True;False
003478-9;2025;2;0;2;True;False
003481-9;2023;2;0;2;True;False
004397-4;2024;2;0;2;True;False
004397-4;2025;2;0;2;True;False
004514-4;2024;1;1;2;True;True
004519-5;2021;2;0;2;True;False
004529-2;2024;2;0;2;True;False
004533-0;2023;2;0;2;True;False
004539-0;2024;2;0;2;True;False
004541-1;2023;2;0;2;True;False
005483-6;2023;2;0;2;True;False
005492-5;2022;2;0;2;True;False
005500-0;2021;2;0;2;True;False
005531-0;2024;2;0;2;True;False
005532-8;2023;2;0;2;True;False
005533-6;2025;2;0;2;True;False
005547-6;2024;2;0;2;True;False
008250-3;2020;2;0;2;True;False
008259-7;2020;2;0;2;True;False
008289-9;2024;2;0;2;True;False
008302-0;2024;2;0;2;True;False
009213-4;2024;2;0;2;True;False
009254-1;2022;2;0;2;True;False
015168-8;2022;2;0;2;True;False
015174-2;2022;2;0;2;True;False
015200-5;2023;2;0;2;True;False
015205-6;2024;2;0;2;True;False
015217-0;2023;2;0;2;True;False
015218-8;2023;1;1;2;True;True
015242-0;2025;2;0;2;True;False
015243-9;2024;2;0;2;True;False
017045-3;2021;1;1;2;True;True
017074-7;2024;2;0;2;True;False
017083-6;2025;2;0;2;True;False
023175-4;2024;0;2;2;False;True
023178-9;2022;2;0;2;True;False
023181-9;2024;2;0;2;True;False
023187-8;2025;2;0;2;True;False
024245-4;2022;1;1;2;True;True
024263-2;2023;2;0;2;True;False
025196-8;2021;2;0;2;True;False
025267-0;2022;2;0;2;True;False
025279-4;2023;2;0;2;True;False
025303-0;2023;2;0;2;True;False
025313-8;2024;2;0;2;True;False
093004-0;2023;2;0;2;True;False
093013-0;2024;2;0;2;True;False
001487-7;2021;1;0;1;True;False
001494-0;2021;1;0;1;True;False
001506-7;2022;1;0;1;True;False
001508-3;2022;1;0;1;True;False
001519-9;2024;1;0;1;True;False
001519-9;2025;1;0;1;True;False
001526-1;2021;1;0;1;True;False
001527-0;2025;1;0;1;True;False
001531-8;2022;1;0;1;True;False
001536-9;2022;0;1;1;False;True
001537-7;2022;1;0;1;True;False
001537-7;2024;0;1;1;False;True
001541-5;2022;1;0;1;True;False
001555-5;2023;1;0;1;True;False
001557-1;2023;1;0;1;True;False
002015-0;2023;1;0;1;True;False
002015-0;2024;1;0;1;True;False
002112-1;2024;1;0;1;True;False
002182-2;2023;1;0;1;True;False
002200-4;2022;1;0;1;True;False
002200-4;2025;0;1;1;False;True
002201-2;2022;1;0;1;True;False
002201-2;2024;1;0;1;True;False
002204-7;2024;1;0;1;True;False
002207-1;2023;1;0;1;True;False
003421-5;2023;1;0;1;True;False
003426-6;2023;1;0;1;True;False
003481-9;2022;1;0;1;True;False
004474-1;2022;0;1;1;False;True
004494-6;2022;1;0;1;True;False
004501-2;2020;1;0;1;True;False
004503-9;2022;1;0;1;True;False
004514-4;2023;1;0;1;True;False
004517-9;2022;1;0;1;True;False
004520-9;2020;1;0;1;True;False
004529-2;2022;1;0;1;True;False
004532-2;2023;1;0;1;True;False
004533-0;2022;1;0;1;True;False
004539-0;2025;1;0;1;True;False
004542-0;2024;1;0;1;True;False
005386-4;2022;1;0;1;True;False
005408-9;2023;0;1;1;False;True
005459-3;2021;1;0;1;True;False
005472-0;2023;1;0;1;True;False
005479-8;2021;1;0;1;True;False
005479-8;2022;1;0;1;True;False
005483-6;2024;1;0;1;True;False
005486-0;2021;1;0;1;True;False
005491-7;2021;1;0;1;True;False
005500-0;2022;1;0;1;True;False
005501-8;2022;0;1;1;False;True
005504-2;2019;1;0;1;True;False
005508-5;2021;1;0;1;True;False
005510-7;2022;1;0;1;True;False
005521-2;2025;1;0;1;True;False
005546-8;2025;1;0;1;True;False
008238-4;2022;1;0;1;True;False
008245-7;2022;1;0;1;True;False
008247-3;2021;1;0;1;True;False
008248-1;2021;1;0;1;True;False
008249-0;2023;1;0;1;True;False
008250-3;2023;1;0;1;True;False
008256-2;2020;1;0;1;True;False
008259-7;2022;1;0;1;True;False
008275-9;2024;1;0;1;True;False
008278-3;2024;1;0;1;True;False
008279-1;2022;1;0;1;True;False
008284-8;2023;1;0;1;True;False
008284-8;2024;1;0;1;True;False
008285-6;2023;1;0;1;True;False
008288-0;2023;1;0;1;True;False
009213-4;2022;1;0;1;True;False
009213-4;2023;1;0;1;True;False
009236-3;2023;1;0;1;True;False
009239-8;2022;1;0;1;True;False
009266-5;2022;1;0;1;True;False
009271-1;2021;1;0;1;True;False
011198-8;2022;1;0;1;True;False
011198-8;2023;1;0;1;True;False
011211-9;2022;0;1;1;False;True
011216-0;2023;0;1;1;False;True
011222-4;2024;1;0;1;True;False
011224-0;2025;1;0;1;True;False
014063-5;2023;1;0;1;True;False
015138-6;2022;1;0;1;True;False
015164-5;2022;1;0;1;True;False
015200-5;2022;1;0;1;True;False
015204-8;2022;1;0;1;True;False
015208-0;2024;1;0;1;True;False
015209-9;2022;1;0;1;True;False
015212-9;2025;1;0;1;True;False
015216-1;2023;1;0;1;True;False
015219-6;2024;1;0;1;True;False
017034-8;2021;1;0;1;True;False
017051-8;2021;1;0;1;True;False
017074-7;2025;1;0;1;True;False
017077-1;2023;1;0;1;True;False
017078-0;2023;1;0;1;True;False
017096-8;2025;1;0;1;True;False
021462-0;2022;1;0;1;True;False
022158-9;2023;1;0;1;True;False
022170-8;2023;1;0;1;True;False
022178-3;2024;1;0;1;True;False
022181-3;2023;1;0;1;True;False
022189-9;2023;1;0;1;True;False
023160-6;2025;0;1;1;False;True
023174-6;2025;1;0;1;True;False
023178-9;2023;0;1;1;False;True
023179-7;2022;0;1;1;False;True
023181-9;2022;1;0;1;True;False
023189-4;2025;1;0;1;True;False
024176-8;2022;1;0;1;True;False
024215-2;2022;1;0;1;True;False
024249-7;2022;1;0;1;True;False
024269-1;2024;1;0;1;True;False
025196-8;2022;1;0;1;True;False
025205-0;2023;1;0;1;True;False
025205-0;2024;1;0;1;True;False
025231-0;2022;1;0;1;True;False
025266-2;2020;1;0;1;True;False
025306-5;2022;1;0;1;True;False
025307-3;2022;1;0;1;True;False
025309-0;2023;1;0;1;True;False
025312-0;2024;1;0;1;True;False
025312-0;2025;1;0;1;True;False
025317-0;2023;1;0;1;True;False
025324-3;2025;1;0;1;True;False
029154-4;2023;1;0;1;True;False
029157-9;2023;1;0;1;True;False
029157-9;2024;1;0;1;True;False
029159-5;2023;1;0;1;True;False
033186-4;2022;0;1;1;False;True
073029-7;2023;0;1;1;False;True
080035-0;2023;1;0;1;True;False
095001-7;2022;0;1;1;False;True
095005-0;2025;1;0;1;True;False
095006-8;2025;1;0;1;True;False
095008-4;2024;1;0;1;True;False
096001-2;2024;1;0;1;True;False
096001-2;2025;1;0;1;True;False
096002-0;2024;1;0;1;True;False
