fipe_code;model_year;localiza_count;movida_count;total_count;localiza_present;movida_present
005540-9;2025;945;368;1313;True;True
005540-9;2024;291;874;1165;True;True
015245-5;2025;727;69;796;True;True
004517-9;2025;740;4;744;True;True
004517-9;2024;714;0;714;True;False
001494-0;2025;593;82;675;True;True
001461-3;2024;477;108;585;True;True
001461-3;2025;330;238;568;True;True
025266-2;2025;69;412;481;True;True
015245-5;2024;451;0;451;True;False
017088-7;2024;435;4;439;True;True
025266-2;2024;107;327;434;True;True
001536-9;2024;420;0;420;True;False
004519-5;2024;0;414;414;False;True
005510-7;2024;164;249;413;True;True
015234-0;2025;185;221;406;True;True
002207-1;2025;0;362;362;False;True
015239-0;2025;205;124;329;True;True
005526-3;2024;308;12;320;True;True
015190-4;2025;6;280;286;True;True
005535-2;2024;33;242;275;True;True
004502-0;2024;253;3;256;True;True
005509-3;2024;236;20;256;True;True
004525-0;2024;243;0;243;True;False
025290-5;2025;0;242;242;False;True
001494-0;2024;220;20;240;True;True
004518-7;2025;239;1;240;True;True
005525-5;2024;85;154;239;True;True
002168-7;2025;0;230;230;False;True
004518-7;2024;209;0;209;True;False
001553-9;2024;181;27;208;True;True
017071-2;2024;206;2;208;True;True
015240-4;2025;197;1;198;True;True
001505-9;2024;197;0;197;True;False
001461-3;2023;161;35;196;True;True
015234-0;2024;138;55;193;True;True
001544-0;2024;117;58;175;True;True
015240-4;2024;171;0;171;True;False
004522-5;2025;160;8;168;True;True
024264-0;2024;130;30;160;True;True
005528-0;2023;159;0;159;True;False
004522-5;2024;153;1;154;True;True
001526-1;2023;140;9;149;True;True
023178-9;2024;130;13;143;True;True
001553-9;2025;120;21;141;True;True
017071-2;2023;132;8;140;True;True
004504-7;2025;138;0;138;True;False
011223-2;2024;132;6;138;True;True
001531-8;2024;133;4;137;True;True
005538-7;2024;62;70;132;True;True
005533-6;2024;81;46;127;True;True
004502-0;2023;123;3;126;True;True
005508-5;2024;125;1;126;True;True
005534-4;2024;109;0;109;True;False
001509-1;2025;91;17;108;True;True
005510-7;2025;24;81;105;True;True
017071-2;2025;100;2;102;True;True
015244-7;2025;97;3;100;True;True
004532-2;2024;99;0;99;True;False
015239-0;2024;96;3;99;True;True
004494-6;2024;95;1;96;True;True
015236-6;2024;93;1;94;True;True
025301-4;2024;85;4;89;True;True
001569-5;2024;72;15;87;True;True
004504-7;2024;87;0;87;True;False
015215-3;2024;87;0;87;True;False
004494-6;2025;85;1;86;True;True
005543-3;2024;43;42;85;True;True
001569-5;2025;77;5;82;True;True
004502-0;2025;81;1;82;True;True
005535-2;2025;75;7;82;True;True
005509-3;2025;33;47;80;True;True
001509-1;2023;55;18;73;True;True
015244-7;2024;71;0;71;True;False
017088-7;2023;68;2;70;True;True
001494-0;2023;64;5;69;True;True
001542-3;2024;49;20;69;True;True
001509-1;2024;50;18;68;True;True
004541-1;2025;64;0;64;True;False
017035-6;2021;62;1;63;True;True
005508-5;2025;59;2;61;True;True
004525-0;2023;60;0;60;True;False
023186-0;2024;57;2;59;True;True
005484-4;2024;58;0;58;True;False
004494-6;2023;57;0;57;True;False
017071-2;2022;57;0;57;True;False
025300-6;2024;57;0;57;True;False
001554-7;2024;45;10;55;True;True
001558-0;2024;54;1;55;True;True
004503-9;2023;55;0;55;True;False
004516-0;2025;54;0;54;True;False
005485-2;2024;51;2;53;True;True
004517-9;2023;48;4;52;True;True
017088-7;2025;50;2;52;True;True
015165-3;2024;49;2;51;True;True
001531-8;2025;42;8;50;True;True
001538-5;2024;50;0;50;True;False
025328-6;2025;0;50;50;False;True
005527-1;2023;48;1;49;True;True
024263-2;2024;49;0;49;True;False
004515-2;2024;47;1;48;True;True
004525-0;2025;48;0;48;True;False
017081-0;2023;47;1;48;True;True
002203-9;2025;0;47;47;False;True
005508-5;2022;47;0;47;True;False
005538-7;2025;31;16;47;True;True
001505-9;2025;46;0;46;True;False
017081-0;2024;46;0;46;True;False
004516-0;2024;45;0;45;True;False
005508-5;2023;44;0;44;True;False
025266-2;2023;35;9;44;True;True
005492-5;2023;40;1;41;True;True
001505-9;2023;39;0;39;True;False
004538-1;2023;39;0;39;True;False
005527-1;2024;26;13;39;True;True
005528-0;2024;37;2;39;True;True
011232-1;2025;39;0;39;True;False
025322-7;2024;39;0;39;True;False
001554-7;2025;36;1;37;True;True
004501-2;2024;35;2;37;True;True
017081-0;2025;36;0;36;True;False
004541-1;2024;35;0;35;True;False
025290-5;2024;0;35;35;False;True
001542-3;2025;33;1;34;True;True
001544-0;2025;1;33;34;True;True
005459-3;2023;34;0;34;True;False
011223-2;2025;30;4;34;True;True
017085-2;2024;6;27;33;True;True
005536-0;2024;32;0;32;True;False
001531-8;2023;27;4;31;True;True
001536-9;2025;2;29;31;True;True
005542-5;2025;30;1;31;True;True
015217-0;2024;30;1;31;True;True
004518-7;2023;29;1;30;True;True
015235-8;2024;30;0;30;True;False
004413-0;2024;27;2;29;True;True
025267-0;2025;3;26;29;True;True
005543-3;2025;17;8;25;True;True
001530-0;2024;23;1;24;True;True
001538-5;2025;24;0;24;True;False
001542-3;2023;19;5;24;True;True
004540-3;2024;24;0;24;True;False
096002-0;2025;24;0;24;True;False
017088-7;2022;22;1;23;True;True
023187-8;2024;23;0;23;True;False
004395-8;2024;22;0;22;True;False
005509-3;2023;22;0;22;True;False
001453-2;2024;21;0;21;True;False
001538-5;2023;20;1;21;True;True
001555-5;2024;21;0;21;True;False
005526-3;2023;21;0;21;True;False
011223-2;2023;20;1;21;True;True
015235-8;2025;21;0;21;True;False
001558-0;2025;19;1;20;True;True
008279-1;2024;20;0;20;True;False
001558-0;2023;19;0;19;True;False
004501-2;2025;14;5;19;True;True
004515-2;2025;15;4;19;True;True
004532-2;2025;19;0;19;True;False
015200-5;2024;19;0;19;True;False
001453-2;2023;17;1;18;True;True
015214-5;2024;17;1;18;True;True
017082-8;2023;18;0;18;True;False
001530-0;2025;16;0;16;True;False
004500-4;2024;16;0;16;True;False
004513-6;2023;16;0;16;True;False
005490-9;2023;13;3;16;True;True
005536-0;2025;12;4;16;True;True
005538-7;2023;0;16;16;False;True
002111-3;2023;15;0;15;True;False
004515-2;2023;15;0;15;True;False
015190-4;2024;15;0;15;True;False
017080-1;2023;15;0;15;True;False
023180-0;2024;14;1;15;True;True
004522-5;2023;14;0;14;True;False
005525-5;2023;14;0;14;True;False
009172-3;2022;14;0;14;True;False
001526-1;2022;12;1;13;True;True
001544-0;2023;12;1;13;True;True
004413-0;2023;11;2;13;True;True
015218-8;2024;11;2;13;True;True
017070-4;2022;13;0;13;True;False
024249-7;2024;7;6;13;True;True
001461-3;2022;8;4;12;True;True
004519-5;2025;6;6;12;True;True
005526-3;2021;12;0;12;True;False
015202-1;2024;12;0;12;True;False
015236-6;2025;10;2;12;True;True
017070-4;2023;11;1;12;True;True
005493-3;2022;11;0;11;True;False
005526-3;2022;11;0;11;True;False
005540-9;2023;0;11;11;False;True
023187-8;2023;11;0;11;True;False
025327-8;2025;0;11;11;False;True
004470-9;2023;10;0;10;True;False
005528-0;2022;10;0;10;True;False
005542-5;2024;8;2;10;True;True
015237-4;2024;9;1;10;True;True
015237-4;2025;9;1;10;True;True
015238-2;2024;10;0;10;True;False
024264-0;2023;8;2;10;True;True
025267-0;2024;3;7;10;True;True
002203-9;2024;1;8;9;True;True
004540-3;2023;9;0;9;True;False
017081-0;2022;9;0;9;True;False
025322-7;2025;8;1;9;True;True
001553-9;2023;8;0;8;True;False
001557-1;2024;8;0;8;True;False
002142-3;2024;8;0;8;True;False
004395-8;2023;8;0;8;True;False
004502-0;2022;8;0;8;True;False
005510-7;2023;8;0;8;True;False
015206-4;2024;8;0;8;True;False
015233-1;2024;8;0;8;True;False
015243-9;2025;6;2;8;True;True
017075-5;2022;6;2;8;True;True
017080-1;2022;8;0;8;True;False
017082-8;2025;8;0;8;True;False
017085-2;2023;8;0;8;True;False
025266-2;2022;8;0;8;True;False
025331-6;2025;0;8;8;False;True
001453-2;2022;7;0;7;True;False
002168-7;2024;0;7;7;False;True
002207-1;2024;0;7;7;False;True
004504-7;2023;7;0;7;True;False
004512-8;2023;7;0;7;True;False
004529-2;2023;7;0;7;True;False
005485-2;2022;7;0;7;True;False
005509-3;2022;7;0;7;True;False
015165-3;2023;7;0;7;True;False
015213-7;2024;7;0;7;True;False
015215-3;2023;7;0;7;True;False
025267-0;2023;7;0;7;True;False
001509-1;2022;6;0;6;True;False
001530-0;2023;6;0;6;True;False
004470-9;2022;6;0;6;True;False
004512-8;2024;6;0;6;True;False
004525-0;2022;6;0;6;True;False
005484-4;2022;6;0;6;True;False
005509-3;2021;6;0;6;True;False
005534-4;2025;6;0;6;True;False
017075-5;2023;4;2;6;True;True
024249-7;2023;6;0;6;True;False
025313-8;2025;5;1;6;True;True
025325-1;2025;2;4;6;True;True
001494-0;2021;5;0;5;True;False
001542-3;2022;4;1;5;True;True
004500-4;2025;4;1;5;True;True
004501-2;2023;5;0;5;True;False
004512-8;2025;5;0;5;True;False
004525-0;2021;5;0;5;True;False
005485-2;2025;5;0;5;True;False
005491-7;2022;4;1;5;True;True
005531-0;2025;5;0;5;True;False
005533-6;2023;4;1;5;True;True
015201-3;2024;5;0;5;True;False
015242-0;2024;5;0;5;True;False
017080-1;2024;5;0;5;True;False
017083-6;2023;5;0;5;True;False
023161-4;2024;0;5;5;False;True
024176-8;2023;5;0;5;True;False
095005-0;2024;5;0;5;True;False
001556-3;2023;4;0;4;True;False
002168-7;2023;4;0;4;True;False
004519-5;2021;4;0;4;True;False
004539-0;2024;4;0;4;True;False
004542-0;2024;4;0;4;True;False
005484-4;2023;4;0;4;True;False
008256-2;2024;4;0;4;True;False
008279-1;2023;4;0;4;True;False
009164-2;2024;4;0;4;True;False
011197-0;2024;4;0;4;True;False
011224-0;2024;4;0;4;True;False
011230-5;2025;4;0;4;True;False
015214-5;2023;3;1;4;True;True
017070-4;2025;4;0;4;True;False
024245-4;2022;2;2;4;True;True
001453-2;2025;3;0;3;True;False
001487-7;2022;3;0;3;True;False
001494-0;2022;3;0;3;True;False
001520-2;2021;3;0;3;True;False
001554-7;2023;3;0;3;True;False
001556-3;2024;3;0;3;True;False
002182-2;2023;3;0;3;True;False
004540-3;2025;3;0;3;True;False
004541-1;2023;3;0;3;True;False
005483-6;2023;3;0;3;True;False
005484-4;2025;3;0;3;True;False
005489-5;2021;3;0;3;True;False
005500-0;2021;3;0;3;True;False
005506-9;2023;3;0;3;True;False
008256-2;2023;3;0;3;True;False
008280-5;2023;3;0;3;True;False
008287-2;2023;3;0;3;True;False
009164-2;2022;3;0;3;True;False
011226-7;2024;1;2;3;True;True
015168-8;2022;3;0;3;True;False
015190-4;2023;3;0;3;True;False
015200-5;2023;3;0;3;True;False
015206-4;2023;3;0;3;True;False
015218-8;2023;2;1;3;True;True
017047-0;2021;3;0;3;True;False
017070-4;2024;1;2;3;True;True
017082-8;2024;3;0;3;True;False
022164-3;2023;2;1;3;True;True
023175-4;2024;2;1;3;True;True
023178-9;2023;0;3;3;False;True
023181-9;2024;3;0;3;True;False
025290-5;2023;3;0;3;True;False
025313-8;2023;3;0;3;True;False
025319-7;2024;3;0;3;True;False
029159-5;2024;3;0;3;True;False
001505-9;2022;2;0;2;True;False
001531-8;2022;2;0;2;True;False
001538-5;2022;2;0;2;True;False
001557-1;2023;2;0;2;True;False
001561-0;2025;2;0;2;True;False
002111-3;2022;2;0;2;True;False
002181-4;2024;0;2;2;False;True
002182-2;2024;2;0;2;True;False
002201-2;2023;2;0;2;True;False
003478-9;2025;2;0;2;True;False
004397-4;2025;2;0;2;True;False
004511-0;2025;0;2;2;False;True
004514-4;2024;1;1;2;True;True
004532-2;2023;2;0;2;True;False
004533-0;2023;2;0;2;True;False
004550-0;2025;1;1;2;True;True
005408-9;2023;0;2;2;False;True
005485-2;2023;2;0;2;True;False
005527-1;2022;2;0;2;True;False
005531-0;2023;2;0;2;True;False
005531-0;2024;2;0;2;True;False
005532-8;2023;2;0;2;True;False
005533-6;2025;2;0;2;True;False
005542-5;2023;1;1;2;True;True
005543-3;2023;2;0;2;True;False
005546-8;2025;2;0;2;True;False
005547-6;2024;2;0;2;True;False
008249-0;2023;2;0;2;True;False
008250-3;2020;2;0;2;True;False
008259-7;2020;2;0;2;True;False
008289-9;2024;2;0;2;True;False
009213-4;2024;2;0;2;True;False
009239-8;2022;2;0;2;True;False
009254-1;2022;2;0;2;True;False
015203-0;2024;2;0;2;True;False
015206-4;2022;2;0;2;True;False
015209-9;2024;2;0;2;True;False
015212-9;2024;2;0;2;True;False
015213-7;2023;2;0;2;True;False
015217-0;2023;2;0;2;True;False
015242-0;2025;2;0;2;True;False
015243-9;2024;2;0;2;True;False
017045-3;2021;2;0;2;True;False
017072-0;2022;2;0;2;True;False
017074-7;2024;2;0;2;True;False
017077-1;2022;2;0;2;True;False
017083-6;2025;2;0;2;True;False
021462-0;2022;2;0;2;True;False
023178-9;2022;1;1;2;True;True
023181-9;2022;1;1;2;True;True
025279-4;2023;2;0;2;True;False
025289-1;2023;2;0;2;True;False
025291-3;2022;2;0;2;True;False
025301-4;2023;2;0;2;True;False
025312-0;2024;2;0;2;True;False
025313-8;2024;2;0;2;True;False
093004-0;2023;2;0;2;True;False
001352-8;2021;1;0;1;True;False
001487-7;2021;1;0;1;True;False
001506-7;2022;0;1;1;False;True
001519-9;2024;1;0;1;True;False
001519-9;2025;1;0;1;True;False
001527-0;2025;1;0;1;True;False
001536-9;2022;0;1;1;False;True
001537-7;2022;1;0;1;True;False
001541-5;2022;1;0;1;True;False
001555-5;2023;1;0;1;True;False
001556-3;2025;0;1;1;False;True
001561-0;2024;1;0;1;True;False
001578-4;2025;0;1;1;False;True
002015-0;2024;1;0;1;True;False
002111-3;2024;1;0;1;True;False
002181-4;2023;1;0;1;True;False
002200-4;2022;1;0;1;True;False
002200-4;2023;1;0;1;True;False
002200-4;2025;0;1;1;False;True
002201-2;2022;1;0;1;True;False
002201-2;2024;1;0;1;True;False
002203-9;2023;1;0;1;True;False
002204-7;2024;1;0;1;True;False
003363-4;2023;1;0;1;True;False
003421-5;2023;1;0;1;True;False
003433-9;2023;1;0;1;True;False
003481-9;2022;1;0;1;True;False
003481-9;2023;1;0;1;True;False
004397-4;2024;1;0;1;True;False
004469-5;2022;1;0;1;True;False
004474-1;2022;0;1;1;False;True
004494-6;2022;1;0;1;True;False
004501-2;2020;1;0;1;True;False
004501-2;2022;0;1;1;False;True
004516-0;2023;1;0;1;True;False
004517-9;2022;1;0;1;True;False
004518-7;2022;1;0;1;True;False
004520-9;2020;1;0;1;True;False
004529-2;2024;1;0;1;True;False
004533-0;2022;1;0;1;True;False
004539-0;2025;1;0;1;True;False
004542-0;2025;1;0;1;True;False
005386-4;2022;1;0;1;True;False
005472-0;2023;1;0;1;True;False
005483-6;2024;1;0;1;True;False
005485-2;2020;1;0;1;True;False
005485-2;2021;1;0;1;True;False
005486-0;2022;1;0;1;True;False
005489-5;2020;0;1;1;False;True
005491-7;2021;1;0;1;True;False
005492-5;2022;1;0;1;True;False
005500-0;2022;0;1;1;False;True
005504-2;2019;1;0;1;True;False
005508-5;2021;1;0;1;True;False
005510-7;2022;1;0;1;True;False
005521-2;2025;1;0;1;True;False
005535-2;2023;1;0;1;True;False
008238-4;2024;1;0;1;True;False
008245-7;2022;1;0;1;True;False
008247-3;2021;1;0;1;True;False
008248-1;2021;1;0;1;True;False
008250-3;2023;1;0;1;True;False
008256-2;2020;1;0;1;True;False
008275-9;2024;1;0;1;True;False
008278-3;2024;1;0;1;True;False
008279-1;2022;1;0;1;True;False
008284-8;2023;1;0;1;True;False
008284-8;2024;1;0;1;True;False
008285-6;2023;1;0;1;True;False
008288-0;2023;1;0;1;True;False
008302-0;2024;1;0;1;True;False
009164-2;2023;1;0;1;True;False
009213-4;2022;1;0;1;True;False
009213-4;2023;1;0;1;True;False
009236-3;2023;1;0;1;True;False
009266-5;2022;1;0;1;True;False
009271-1;2021;1;0;1;True;False
011197-0;2022;1;0;1;True;False
011197-0;2023;1;0;1;True;False
011198-8;2022;1;0;1;True;False
011216-0;2023;1;0;1;True;False
011222-4;2024;1;0;1;True;False
011224-0;2023;1;0;1;True;False
011235-6;2025;0;1;1;False;True
014063-5;2023;1;0;1;True;False
015138-6;2022;1;0;1;True;False
015164-5;2022;1;0;1;True;False
015174-2;2022;1;0;1;True;False
015190-4;2022;0;1;1;False;True
015205-6;2024;1;0;1;True;False
015212-9;2025;1;0;1;True;False
015233-1;2025;1;0;1;True;False
015238-2;2025;1;0;1;True;False
017034-8;2021;0;1;1;False;True
017074-7;2025;1;0;1;True;False
017087-9;2023;1;0;1;True;False
017096-8;2025;1;0;1;True;False
022158-9;2023;1;0;1;True;False
022164-3;2022;1;0;1;True;False
022170-8;2022;1;0;1;True;False
022171-6;2022;1;0;1;True;False
022181-3;2023;1;0;1;True;False
022189-9;2023;1;0;1;True;False
023160-6;2025;0;1;1;False;True
023163-0;2022;0;1;1;False;True
023174-6;2024;1;0;1;True;False
023174-6;2025;1;0;1;True;False
023179-7;2022;0;1;1;False;True
023187-8;2025;1;0;1;True;False
023189-4;2025;1;0;1;True;False
024176-8;2022;1;0;1;True;False
024215-2;2023;1;0;1;True;False
024249-7;2022;1;0;1;True;False
024263-2;2023;1;0;1;True;False
025196-8;2021;1;0;1;True;False
025197-6;2023;1;0;1;True;False
025266-2;2026;0;1;1;False;True
025281-6;2024;0;1;1;False;True
025300-6;2023;1;0;1;True;False
025303-0;2023;1;0;1;True;False
025306-5;2022;1;0;1;True;False
025307-3;2022;1;0;1;True;False
025309-0;2023;1;0;1;True;False
025312-0;2025;1;0;1;True;False
025319-7;2023;1;0;1;True;False
029142-0;2021;1;0;1;True;False
029154-4;2023;1;0;1;True;False
029157-9;2023;1;0;1;True;False
029157-9;2024;1;0;1;True;False
073029-7;2023;0;1;1;False;True
080035-0;2023;1;0;1;True;False
083015-1;2024;1;0;1;True;False
093005-9;2024;0;1;1;False;True
093013-0;2024;1;0;1;True;False
095005-0;2025;1;0;1;True;False
095006-8;2025;1;0;1;True;False
095007-6;2024;1;0;1;True;False
095008-4;2024;1;0;1;True;False
096001-2;2024;1;0;1;True;False
096001-2;2025;1;0;1;True;False
096002-0;2024;1;0;1;True;False
096003-9;2025;1;0;1;True;False
600005;2024;0;1;1;False;True
